Farming 2 (30 * 40)
 M  M  M  M  M  M  M  M  M  M  M  M  M  M  M  M  G  M  M  M  M  M  M  M  M  M  M  M  M  M  M  M  M  M  M  M  M  M  M  M  
 M  M  M  M  M  M  M  M  M  M  M  X  M  M  M  G  G  G  G  G  G  G  G  G  G  G  G  G  G  G  G  G  G  G  G  G  G  G  G  M 
 M  G  G  G  G  G  G  G  G  G  G  G  G  G  G  G  G  G  G  G  G  G  G  G  G  G  G  G  G  G  G  G  G  G  G  G  G  G  G  M 
 M  G  G  G  G  G  G  G  G  G  G  G  G  G  G  G  G  G  G  G  G  G  G  G  G  G  G  G  G  G  G  G  G  G  G  G  G  G  G  M 
 M  G  G  G  G  9  9  9  9  9  9  9  G  G  G  G  G  G  G  G  G  G  G  G  G  G  G  G  G  G  G  G  G  G  G  G  G  G  G  M 
 M  G  G  G  G  9  9  9  9  9  9  9  G  G  G  G  G  G  G  G  G  G  G  G  G  G  G  G  G  G  G  G  G  G  G  G  G  G  G  M 
 M  G  G  G  G  9  9  9  9  9  9  9  G  G  G  G  G  G  G  G  G  G  G  G  G  G  G  G  G  G  G  G  G  G  G  G  G  G  G  M 
 M  G  G  G  G  9  9  9  9  9  9  9  G  G  G  G  G  G  G  G  G  G  G  G  G  G  G  G  G  G  G  G  G  G  G  G  G  G  G  M 
 M  G  G  G  G  9  9  9  9  9  9  9  G  G  G  G  G  G  G  G  G  G  G  G  G  G  G  G  G  G  G  G  G  G  G  G  G  G  G  G 
 M  G  G  G  G  G  G  G  G  G  G  G  G  G  G  G  G  G  G  G  G  G  G  G  L  L  L  L  L  G  G  G  G  G  G  G  G  G  G  M 
 M  G  G  G  G  G  G  G  G  G  G  G  G  G  G  G  G  G  G  G  G  G  G  L  L  L  L  L  G  G  G  G  G  G  G  G  G  G  G  M 
 M  G  G  G  G  G  G  G  G  G  G  G  G  G  G  G  L  L  L  L  L  L  L  L  L  L  L  L  L  L  L  G  G  G  G  G  G  G  G  M 
 M  G  G  G  G  G  G  G  G  G  G  G  G  G  G  L  L  L  L  L  L  L  L  L  L  L  L  L  L  L  L  L  L  L  G  G  G  G  G  M 
 G  G  G  G  G  G  G  G  G  G  G  G  G  G  G  G  L  L  L  L  L  L  L  L  L  L  L  L  L  L  L  L  G  G  G  G  G  G  G  M 
 M  G  G  G  G  G  G  G  G  G  G  G  G  G  G  G  G  G  G  G  L  L  L  L  L  L  L  L  L  L  L  L  L  G  G  G  G  G  G  M 
 M  M  G  G  G  G  G  G  G  G  G  G  G  G  G  G  G  G  G  L  L  L  L  L  L  L  L  L  L  L  L  L  L  L  G  G  G  G  G  M 
 M  M  G  G  G  G  G  G  G  G  G  G  G  G  G  G  G  G  G  G  G  G  G  G  G  G  G  L  L  L  L  L  L  L  G  G  G  G  G  M 
 M  M  G  G  G  G  G  G  G  G  G  G  G  G  G  G  G  G  G  G  G  G  G  G  G  G  G  L  L  L  L  L  L  L  L  G  G  G  G  M 
 M  M  G  G  G  G  G  G  G  G  G  G  G  G  G  G  G  G  G  G  G  G  G  G  G  G  G  G  G  G  G  G  G  G  G  G  G  G  G  M 
 M  M  G  G  G  G  G  G  G  G  G  G  G  G  G  G  G  G  G  G  G  G  G  G  G  G  G  G  G  G  G  G  G  G  G  G  G  G  G  M 
 M  G  G  G  G  G  G  G  G  G  G  G  G  G  G  G  G  G  G  G  G  G  G  G  G  G  G  G  G  G  G  G  G  G  G  G  G  G  G  M 
 M  G  G  G  G  G  G  G  G  G  G  G  G  G  G  G  G  G  G  G  G  G  G  G  G  G  G  G  G  G  G  G  G  G  G  G  G  G  G  M 
 M  G  G  G  G  G  G  G  G  G  G  G  G  G  G  G  G  G  G  G  G  G  G  G  G  G  G  G  G  G  H  H  H  H  H  G  G  G  G  M 
 M  G  G  G  G  G  G  G  G  G  G  G  G  G  G  G  G  G  G  G  G  G  G  G  G  G  G  G  G  G  H  H  H  H  H  G  G  G  G  M 
 M  G  G  G  G  G  G  G  G  G  G  G  G  G  G  G  G  G  G  G  G  G  G  G  G  G  G  G  G  G  H  H  H  H  H  G  G  G  G  M 
 M  G  G  G  G  G  G  G  G  G  G  G  G  G  G  G  G  G  G  G  G  G  G  G  G  G  G  G  G  G  H  H  H  H  H  G  G  G  G  M 
 M  G  G  G  G  G  G  G  G  G  G  G  G  G  G  G  G  G  G  G  G  G  G  G  G  G  G  G  G  G  G  G  G  G  G  G  G  G  G  M 
 M  G  G  G  G  G  G  G  G  G  G  G  G  G  G  G  G  G  G  G  G  G  G  G  G  G  G  G  G  G  G  G  G  G  G  G  G  G  G  M 
 M  G  G  G  G  G  G  G  G  G  G  G  G  G  G  G  G  G  G  G  G  G  G  G  M  M  M  M  M  M  M  M  G  G  G  G  G  G  G  M 
 M  M  M  M  M  M  M  M  M  M  M  M  M  M  M  M  M  M  M  M  M  M  M  G  M  M  M  M  M  M  M  M  M  M  M  M  M  M  M  M 
