 
 G  G  G  G  G  G  G  G  G  G  G  G  *  G  G  G  G  G  G  G  G  G  G  G  L  L  L  L  L  L  G  G  G  G  G  G  G  G  G  G 
 G  G  G  G  G  G  G  G  G  G  G  G  *  G  G  G  G  G  G  G  G  G  G  G  G  L  L  L  L  L  L  G  G  F  F  F  F  F  G  G 
 G  G  G  B  B  B  B  B  B  G  G  G  *  G  I  I  I  I  I  I  I  I  G  G  G  L  L  L  L  L  L  G  G  F  F  F  F  F  G  G 
 G  G  G  B  B  B  B  B  B  G  G  G  *  G  I  I  I  I  I  I  I  I  G  G  L  L  L  L  L  L  G  G  G  F  F  F  F  F  G  G 
 G  G  G  B  B  B  B  B  B  G  G  G  *  G  I  I  I  I  I  I  I  I  G  G  G  L  L  L  L  L  L  G  G  F  F  F  F  F  G  G 
 G  G  G  B  B  B  B  B  B  G  G  G  *  G  I  I  I  I  I  I  I  I  G  G  L  L  L  L  L  L  G  G  G  G  G  *  G  G  G  G 
 G  G  G  G  G  G  G  *  G  G  G  G  *  G  I  I  I  I  I  I  I  I  G  G  G  L  L  L  L  L  G  G  G  G  G  *  G  G  G  G 
 G  G  G  G  G  G  G  *  G  G  G  G  *  G  G  G  G  *  G  G  G  G  G  G  G  L  L  L  L  L  L  G  G  G  G  *  G  G  G  G 
 G  *  *  *  *  *  *  *  *  *  *  *  *  *  *  *  *  *  G  G  G  G  G  G  G  G  L  L  L  L  L  G  G  G  G  *  G  G  *  * 
 G  *  G  G  G  G  G  G  *  *  *  *  *  *  *  *  *  G  G  G  G  G  G  G  G  L  L  L  L  L  G  G  G  G  G  *  G  G  *  G 
 G  *  G  G  G  G  G  G  *  *  *  *  *  *  *  *  *  *  *  *  *  *  *  *  *  *  *  *  *  *  *  *  *  *  *  *  *  *  *  G 
 G  *  G  G  G  G  G  G  *  *  *  *  *  *  *  *  *  G  G  G  G  G  G  G  G  G  L  L  L  L  L  G  G  G  G  G  G  G  *  G 
 *  *  G  G  G  G  G  G  *  *  *  *  *  *  *  *  *  G  G  G  G  G  G  G  G  G  L  L  L  L  L  G  G  G  G  G  G  G  *  G 
 G  G  G  G  G  G  G  G  *  *  *  *  *  *  *  *  *  G  G  G  G  G  G  G  G  G  L  L  L  L  L  G  G  G  G  G  G  G  *  G 
 G  G  R  R  R  R  R  G  *  *  *  *  *  *  *  *  *  G  K  K  K  K  K  K  K  G  G  G  L  L  L  L  G  G  G  G  T  G  *  G 
 G  G  R  R  R  R  R  G  *  *  *  *  *  *  *  *  *  G  K  K  K  K  K  K  K  G  G  G  G  L  L  L  L  G  G  G  T  G  *  G 
 G  G  R  R  R  R  R  G  *  *  *  *  *  *  *  *  *  G  K  K  K  K  K  K  K  G  G  G  L  L  L  L  L  G  G  G  T  T  *  G 
 G  G  G  G  *  G  G  G  *  *  *  *  *  *  *  *  *  G  K  K  K  K  K  K  K  G  G  L  L  L  L  L  L  G  G  T  T  G  *  G 
 G  G  G  G  *  G  G  G  *  *  *  *  *  G  G  G  G  G  G  G  G  G  *  G  G  G  G  L  L  L  L  G  G  G  G  G  T  T  *  G 
 G  G  G  G  *  *  *  *  *  *  *  *  *  *  G  G  G  G  G  G  G  G  *  G  G  G  G  L  L  L  L  L  L  G  G  T  T  T  *  G 
 G  G  G  G  G  G  G  G  G  *  G  G  G  *  *  *  *  *  *  *  *  *  *  G  G  G  L  L  L  L  L  G  G  G  G  T  G  G  *  G 
 G  G  G  G  G  G  G  G  G  *  G  G  G  G  G  G  G  G  G  G  G  G  G  G  G  L  L  L  L  L  G  G  G  G  T  T  G  G  *  G 
 G  G  G  G  G  G  G  G  G  *  G  G  G  G  G  G  G  G  G  G  G  T  G  G  G  L  L  L  L  G  G  G  G  G  G  G  G  G  *  G 
 G  G  G  G  G  G  G  G  G  *  G  C  C  C  C  C  C  G  G  T  T  T  G  L  L  L  L  L  G  G  J  J  J  J  J  J  J  G  *  G 
 G  G  G  G  G  G  G  G  G  *  G  C  C  C  C  C  C  G  G  G  T  G  G  G  L  L  L  L  G  G  J  J  J  J  J  J  J  G  *  G 
 G  G  G  G  G  G  G  G  G  *  G  C  C  C  C  C  C  G  G  G  T  T  G  G  G  L  L  L  L  G  J  J  J  J  J  J  J  G  *  G 
 G  G  G  G  G  G  G  G  G  *  G  C  C  C  C  C  C  G  G  G  T  T  G  L  L  L  L  L  L  G  G  G  G  *  G  G  G  G  *  G 
 G  G  G  G  G  G  G  G  G  *  G  G  G  *  G  G  G  G  G  T  T  G  G  G  L  L  L  L  L  L  G  G  G  *  *  *  *  *  *  G 
 G  G  G  G  G  G  G  G  G  *  *  *  *  *  G  G  G  G  T  T  G  G  G  L  L  L  L  L  L  G  G  G  G  G  G  G  G  G  G  G 
 G  G  G  G  G  G  G  G  G  *  G  G  G  G  G  G  G  G  G  G  G  G  L  L  L  L  L  L  L  G  G  G  G  G  G  G  G  G  G  G 
