 M  M  M  M  M  M  M  M  M  M  M  M  M  M  M  M  M  M  M  M  M  M  M  *  M  M  M  M  M  M  M  M  M  M  M  M  M  M  M  M
 M  M  M  M  M  M  M  M  M  M  M  M  M  M  G  G  G  G  G  G  G  G  G  *  G  G  G  G  G  G  G  G  G  G  G  G  G  G  G  M
 M  M  M  M  M  M  M  M  M  M  M  M  M  G  G  G  G  G  G  G  G  G  G  *  G  G  G  G  G  G  G  G  G  G  G  G  G  G  G  M
 M  M  M  M  M  M  M  M  M  M  M  G  G  G  G  G  G  G  G  G  G  G  G  *  G  G  G  G  G  G  G  G  G  G  G  G  G  G  G  M
 M  M  M  M  M  M  M  M  M  M  M  G  G  G  G  G  G  G  G  G  G  G  G  *  G  G  G  G  G  G  G  G  G  G  G  G  G  G  G  M
 M  M  M  M  M  M  M  G  G  G  G  G  G  G  G  G  G  G  G  G  G  G  G  *  G  G  G  G  G  G  G  G  G  G  G  G  G  G  G  M
 M  M  M  M  M  M  M  G  G  G  G  G  G  G  G  G  G  G  G  G  G  G  G  *  G  G  G  G  G  G  G  G  G  G  G  G  G  G  G  M
 M  M  M  M  M  G  G  G  G  G  G  G  G  G  G  G  G  G  G  G  G  G  G  *  G  G  G  G  G  G  G  G  G  G  G  G  G  G  G  M
 *  *  *  *  *  *  *  *  *  *  *  *  *  *  *  *  *  *  *  *  *  *  *  *  G  G  G  G  G  G  G  G  G  G  G  G  G  G  G  M
 M  G  G  G  G  G  G  G  G  G  G  *  *  *  *  *  *  *  *  *  *  *  *  *  G  G  G  G  G  G  G  G  G  G  G  G  G  G  G  M
 M  M  G  G  G  G  G  G  G  G  G  G  G  G  G  G  *  G  G  G  G  G  G  G  G  G  G  G  G  G  G  G  G  G  G  G  G  G  G  M
 M  G  G  G  G  G  G  G  G  G  G  G  G  G  G  G  *  G  G  G  G  G  G  G  G  G  G  G  G  G  G  G  G  G  G  G  G  G  G  M
 M  G  G  G  G  G  G  G  G  G  G  G  G  G  G  G  *  G  G  G  G  G  G  G  G  G  G  G  G  G  G  G  G  G  G  G  G  G  G  M
 M  G  G  G  G  G  G  G  G  G  G  G  G  G  G  G  *  G  G  G  G  G  G  G  G  G  G  G  G  G  G  G  G  G  G  G  G  G  G  M
 M  G  G  G  G  G  G  G  G  G  G  G  G  G  G  G  *  G  G  G  G  G  G  G  G  G  G  G  G  G  G  G  G  G  G  G  G  G  M  M
 M  G  G  G  G  G  G  G  G  G  G  G  G  G  G  G  *  G  G  G  G  G  G  G  G  G  G  G  G  G  G  G  G  G  G  G  G  M  M  M
 M  G  G  G  G  G  G  G  G  G  G  G  G  G  G  G  *  G  G  G  G  G  G  G  G  G  G  G  G  G  G  G  G  G  G  G  M  M  M  M
 M  G  G  G  G  G  G  G  G  G  G  G  G  G  G  G  *  G  G  G  G  G  G  G  G  G  G  G  G  G  G  G  G  G  G  M  M  M  M  M
 M  G  G  G  G  G  G  G  G  G  G  G  G  G  G  G  *  G  G  G  G  G  G  G  G  G  G  G  G  G  G  G  G  G  G  M  M  M  M  M
 M  G  G  G  G  G  G  G  G  G  G  G  G  G  G  G  *  G  G  G  G  G  G  G  G  G  G  G  G  G  G  G  G  G  M  M  M  M  M  M
 M  G  G  G  G  G  G  G  G  G  G  G  G  G  G  G  *  G  G  G  G  G  G  G  G  G  G  G  G  G  G  G  M  M  M  M  M  M  M  M
 M  G  G  G  G  G  G  G  G  G  G  G  G  G  G  G  *  G  G  G  G  G  G  G  G  G  G  G  G  G  G  G  M  M  M  M  M  M  M  M
 M  G  G  G  G  G  G  G  G  G  G  G  G  G  G  G  *  G  G  G  G  G  G  G  G  G  G  G  G  G  G  M  M  M  M  M  M  M  M  M
 M  G  G  G  G  G  G  G  G  G  G  G  G  G  G  G  *  G  G  G  G  G  G  G  G  G  G  G  G  G  G  M  M  M  M  M  M  M  M  M
 M  G  G  G  G  G  G  G  G  G  G  G  G  G  G  G  *  G  G  G  G  G  G  G  G  G  G  G  G  G  M  M  M  M  M  M  M  M  M  M
 M  G  G  G  G  G  G  G  G  G  G  G  G  G  G  G  *  G  G  G  G  G  G  G  G  G  G  G  M  M  M  M  M  M  M  M  M  M  M  M
 M  G  G  G  G  G  G  G  G  G  G  G  G  G  G  G  *  G  G  G  G  G  G  G  G  G  G  G  G  G  M  M  M  M  M  M  M  M  M  M
 M  G  G  G  G  G  G  G  G  G  G  G  G  G  G  G  *  G  G  G  G  G  G  G  G  G  G  G  G  G  G  M  M  M  M  M  M  M  M  M
 M  G  G  G  G  G  G  G  G  G  G  G  G  G  G  G  *  G  G  G  G  G  G  G  G  G  G  G  G  G  G  M  M  M  M  M  M  M  M  M
 M  M  M  M  M  M  M  M  M  M  M  M  M  M  M  M  *  M  M  M  M  M  M  M  M  M  M  M  M  M  M  M  M  M  M  M  M  M  M  M
